15.ox
.s.............
..o...o........
.s..o..........
.......o.......
.o.............
.s.............
.....o.........
..o.....o...o..
...o...o....o..
..o............
...............
..........o...o
...............
...............
...............
