hello world.ox
...............
..o...o........
....o..........
.......o.......
.o.............
...............
.....o.........
..o.....o...o..
...o...o....o..
..o............
...............
..........o...o
...............
...............
...............
